+---+---+---+---+
        |   |   |
+---+   +---+   +
|               |
+   +---+   +---+
|   |           |
+---+   +---+   +
|           |    
+---+---+---+---+