+---+---+---+---+
                |
+---+---+---+   +
|   |       |   |
+   +---+---+   +
|   |   |       |
+---+   +   +---+
|       |        
+---+---+---+---+
